25 3
1111111111111111111111111111111
1000000000000000000000000000001
1100000000000000000000000000011
1110000000000000000000000001111
1111000010000000100010000001111
1111101100110000000000000011111
1111111100111000000000000111111
1101110000001100000000000110111
1100110000001100001000000110011
1100111100101100000000000000011
1110111100111110000001000000111
1000000000000000000000000001111
1000000000000001000010010001111
1000000000000000000000000001111
1111111111111111111111111111111
